        1111111111111111111111111
   1     1000000000110000000000001
        1011000001110000000000001
        1001000000110000000000001
111111111011000001110000000000001
100000000011000001110111111111111
11110111111111011100000010001
11110111111111011101010010001111111111111111111111111111
110000001101010111000000100010000000000000000000000000001
10000000000000001100000010000111111111111111111111111111
10000000000000001101010010001
11000001110101011111011110N0111
11110111 1110101 101111010001
11111111 1111111 111111111111